##################################################################
##@   ##                                                        ##
##                                                              ##
#######                                                         ##
##              #                                               ##
##                                                              ##
##                                                              ##
##                                                              ##
##                                                              ##
##                                                              ##
##                                                              ##
##                                                              ##
##                                                              ##
##                                                              ##
##                                                              ##
##                                                              ##
##                                                              ##
##                                                              ##
##                                                              ##
##                                                              ##
##                                                              ##
##                                                              ##
##                                                              ##
##################################################################
